3 3 3 11 12 3 3 3 3 3 3 3 3 3 3 3 3 3 3 3 3 3
3 3 3 3 3 3 3 3 3 3 3 3 3 3 3 3 3 3 3 3 3 3
4 4 4 4 4 4 4 4 4 4 4 4 4 5 5 5 4 4 4 4 4 4
4 4 4 4 4 4 4 4 4 4 4 4 4 5 5 5 4 4 4 4 4 4
4 4 4 4 4 4 4 4 4 4 4 4 4 5 5 5 4 4 4 4 4 4
3 3 3 3 3 3 3 3 3 3 3 3 3 3 3 3 3 3 3 3 3 3
3 3 3 3 3 3 3 3 3 3 3 3 3 3 3 3 3 3 3 3 3 3
